WWWWWWWWWWWWWWWWWWWW
W  W  CC  WWW  C P W
W  WWW   WW   W    W
WCCWCCW  W  WWWC   W
W  W  W  W  C W WWWW
W M   E  WWW  WS WWW
WWWWWWW    W  W  WWW
W E   WWWW W  W WWWW
W  W  W MW W CW  WWW 
W  W  W   M E    WWW
W  W  WWWWWWWWW WWWW
W  W    MF C WW    W
W  WWWWWW     W   SW
W         E        W
WWWWWWWWWWWWWWWWWWWW